0 0 0 0 0 0 0 0 0 0 0 0 0 0 0  
0 4 1 2 1 1 1 2 1 1 1 1 1 1 0 
0 1 2 1 1 1 2 1 1 1 1 1 2 1 0 
0 1 1 1 2 1 1 2 1 1 1 2 1 1 0 
0 1 1 5 5 1 2 1 1 1 1 1 1 1 0  
0 1 1 5 5 2 1 1 1 2 1 1 3 1 0  
0 1 2 1 1 1 1 1 1 1 1 1 1 1 0 
0 1 1 1 1 1 1 1 3 5 5 1 1 1 0 
0 1 1 2 1 1 2 1 1 5 5 1 1 1 0 
0 1 1 1 1 1 1 1 1 1 2 1 1 1 0 
0 1 1 2 1 1 3 1 1 1 2 1 1 1 0  
0 1 5 5 1 1 1 1 1 1 1 1 1 1 0  
0 1 5 5 1 1 2 1 1 1 1 1 1 1 0 
0 1 1 1 1 1 1 1 1 1 1 1 1 1 0 
0 0 0 0 0 0 0 0 0 0 0 0 0 0 0 
